*****************************************************
*             %                                     *
*                            ^                      *
*     ****        ^                        ****     *
*        *                      ^          *        *
*        *                                 *        *
*        *                                 *        *
*        *        *****************        *        *
*        *        *               *        *        *
*        *        |      $$$      *        *  ^     *
*        *        |      $$$      *        *        *
*        *        |      $$$      *        *        *
*        *        *              #*        *        *
*        *        *****************        *      ^ *
*    ^   *                                 *        *
*        *                            %    *        *
*        *         ^                       *        *
*     ****                        ^        ****     *
*   ^                                               *
*                                        ^          *
*****************************************************
